6900000
,XXXXXXXXXXXXXXXXXX
X                X
X                X
X  XXXXXXXXXXXX  X
X  X X   XXX     X
X      X     X   X
XXX  XXX X   X   X
X X      X X X   X
X X XXX  X X X   X
X X X FXX        X
X   X    X X X   X
X XXXX   X X X   X
X X   X X  X X   X
X X     X  X X   X
X X   X X  X X   X
X   X X X  X X   X
X X X   X    X   X
X   XXXX    XXXX X
XXXX  X     X    X
X GX      XXX X  X
X        X  X    X
X  XXXXXX   X X GX
XX        X   X  X
XXXXXXXX  XX  XF X
XXXXXXXXXXXXXXXXXX
                  
                W 
                W 
                W 
    W       PWW W 
     W          W 
                W 
                W 
                P 
            WW  P 
        W       P 
 C      W       W 
                W 
                W 
                W 
               CW 
           W      
           W    W 
     W     W  WPW 
 PW      W     PW 
      W        PW 
               PW 
               PH 
                P 
                  
r