540000
,XXXXXXXXXXXXXXXXXX
X          X     X
XXXXX X XXXX X XXX
X   X X  X X X   X
X X X X X    XXX X
X X X X XXXX X X X
X X   X      X X X
X XXXXXXXXXX   X X
X     X   X XXXX X
XXXXX X X X      X
X     X X XXX XXXX
X   X X          X
X XXXXXXXXXXXX XXX
X X              X
X XXXX XXXXX  X  X
XGX X        XXX X
X  FX XXXXX X XX X
XXXXX X   X X   XX
X   X X X X XX X X
X X X   X X X  X X
X X XXXXX XXX XX X
X X       X    X X
X XXXXXXXXX XXXX X
X                X
XXXXXXXXXXXXXXXXXX
                  
 WWWWWWWWWW WWWWW 
     W W    W W   
 WWW W WW W W WWW 
 W W W W WWWW   W 
 W W W W    W W W 
 W WWW WWWWWW W W 
 W          WWW W 
 WWWWW WWW W    W 
     W W W WWWWWW 
 WWWWW W W   W    
 WCW W WWWWWWWWWW 
 W            W   
 W WWWWWWWWWWWWWW 
 W    W     WW WW 
 W W WWWWWWWW   W 
 WWW W     W W  W 
     W WWW W HWW  
 WWW W W W W  W W 
 W W WWW W W WW W 
 W W     W   W  W 
 W WWWWWWW WWWW W 
 W         W    W 
 WWWWWWWWWWWWWWWW 
                  
r