6600000
,XXXXXXXXXXXXXXXXXX
X X XX X         X
X            XX  X
X X XX X X XX    X
X X XX   X  X X  X
X X XXX  XX X X  X
X X XX   X  X X  X
X X XX X   XX X  X
X X XX XXXXX  X  X
X X X     FX  X  X
X X  X XXXX X X  X
X X X       X X  X
X X X  XXXX X X  X
X X X         X GX
X X  X XXXXXX X GX
X X X         X GX
X X  X XXXXXXXX GX
X X X         X GX
X XFXX XX XXX X GX
X X     X  FX X GX
X XX X  XXXXX X GX
X    X  XFX   X GX
X XX X  X X XXXFGX
X    X        F GX
XXXXXXXXXXXXXXXXXX
                  
                P 
          PWW   P 
 C      P       P 
                P 
        P    P  W 
                W 
      C         W 
                W 
                W 
                  
                  
               PP 
           W   PW 
               PW 
       W       PW 
               PW 
            CW PW 
         C     PW 
       W       PW 
               PW 
               PW 
 C       C     PW 
             PPHW 
                  
r