6600000
,XXXXXXXXXXXXXXXXXX
X                X
X  XX   XXX      X
XXXXXXX   XXXXX  X
X    GXX      XX X
X      X       X X
X F           XX X
X F            X X
X              X X
X                X
X                X
X                X
X                X
X                X
X F              X
X F            X X
X              X X
XF             X X
XF             X X
XF            XX X
XF   G        X  X
XXXXXXX      X   X
X     XX    XX   X
X         F X    X
XXXXXXXXXXXXXXXXXX
                  
 H                
                  
         P        
         P        
   PP    PPPPP    
   PCC   P   P    
   PPP   P   P    
   PPP       P    
   PCC       P    
   PP        PP   
       PPP   PPP  
   PP    PC  PPPP 
   PCC       PPP  
   PPP       PP   
   PPP       P    
   PCC       P    
   PP    P   P    
         P   P    
         PPPPP    
         P        
         P        
                  
                  
                  
r