6300000
,XXXXXXXXXXXXXXXXXX
XXXXXXXXXXXX  XXXX
X                X
XX    X          X
XXXXXXX          X
X                X
X                X
X                X
X                X
X                X
X                X
X                X
X               FX
X                X
X                X
X                X
X                X
X                X
X                X
X                X
X                X
X                X
X            F   X
X  G             X
XXXXXXXXXXXXXXXXXX
                  
                  
 C                
                  
                  
 H                
                  
                  
                  
                  
                  
   PPPPPPPP       
   PPPPPPPPP      
 PPPPP  PPPPP     
 PPPP P   PP      
 PPP      P PPPP  
      P      PPP  
  P   P  P    PPP 
               PP 
    P           P 
   P    P       P 
 PP               
 CP   P           
 PP               
                  
r