6300000
,XXXXXXXXXXXXXXXXXX
X            X   X
X              X X
XF          X    X
X                X
X          X     X
X          X  X  X
X          X X   X
X                X
X          X     X
X              X X
X         XXFX   X
X        X       X
X          X     X
X       X   X X  X
X     X       X  X
X     X  XX      X
X    X      X X  X
X          X   X X
X X              X
X    X   X X X   X
X           X    X
XX     X   X   F X
X                X
XXXXXXXXXXXXXXXXXX
                  
 HP P  P P        
 P C P P PP       
   PP  P PP   P   
 PP  P P P        
   P    P P   P   
  P  PPP P        
    P  P       PP 
 PPP              
  PP P C P    P   
      P           
  P P P P         
 P     P    P     
  P               
     P P     P    
  P P             
   P       C      
                  
                  
                  
                  
                  
                  
                  
                  
r