6600000
,XXXXXXXXXXXXXXXXXX
X  X             X
XX   X X X X  X  X
X  XXX X X X XX  X
X GXX  X  X      X
X GXX XXX X  XX  X
X  X            XX
XX XX XXX X  XX  X
X  X  X    XX    X
X  X FX XFX   X  X
X  XXXXXXX  X    X
X  X     XX XXX  X
X  X XXX X       X
X  X XFX XX  XXX X
X  X X X XXX X X X
X  X X    X    X X
X  X XXXX X  XXX X
X  X      X      X
X  X XXXX XX X X X
X  X    X X    X X
X  X X XX XXXX X X
X    X X        XX
X  X X X XXXXX X X
X      X       G X
XXXXXXXXXXXXXXXXXX
                  
                W 
                W 
 PW             W 
 PW  W          W 
 PW  P      W   W 
 PW       W WWW   
     W      W   P 
     W CW    PWWW 
 CP  W       W WW 
             WWWW 
               WW 
    P        WWWW 
  P W      W    W 
      C       W W 
      WW     WW W 
                W 
     W         WW 
                W 
       W        W 
                W 
                  
                H 
            PPWWW 
                  
r