6600000
,XXXXXXXXXXXXXXXXXX
X     X          X
X XXX X  XXXX    X
X XFX X  X    F  X
X X X X  X       X
X X X X X        X
X X X   X        X
X   X X XX       X
XX  X X  XX      X
XXXX  X XXFX     X
X     X    X     X
X   X  XX        X
X X     FX      FX
X     X    XF    X
X X     X    X   X
X    X    X      X
X X    X    X    X
X   X    XF      X
X X   X    X     X
X  X    X      F X
X    X    X      X
X X    X  F      X
X X X    X  XXXX X
X     X    FX   GX
XXXXXXXXXXXXXXXXXX
                  
              WWW 
 C      P     WWW 
        P    PPWW 
       WP  PPPWWW 
       P  CPPPWWW 
              WWW 
          PPPPWWW 
              WWW 
              WWW 
              WWW 
            C WWW 
 C     PW     WW  
     P        WWW 
 C     P      WWW 
              WWW 
 C    P       WWW 
              WWW 
 C            WWW 
              W W 
    P         WWW 
 C    C     WWWWW 
   C              
             PPH  
                  
r