6300000
,XXXXXXXXXXXXXXXXXX
X      F  F    X X
X X           X  X
X  X         X   X
X   X      XX    X
X    X     X     X
X     X   X      X
X      X X       X
X                X
X                X
X                X
X       X        X
X                X
X         X      X
X       X        X
X       X        X
X       X        X
X                X
X       X        X
X                X
X         X      X
X                X
X                X
X  F G       F   X
XXXXXXXXXXXXXXXXXX
                  
 H                
                  
                  
     C            
                  
                  
                  
       PPP        
      PPPPP       
     PPP PPP      
     PP   PPP     
    PP      PP    
   PP       PPP   
  PP          PP  
 P             P  
 PP            PP 
  CP          PP  
   PP        PP   
    CP      PP    
     PP    PP     
      CP  PP      
       PPPP       
         P        
                  
d