6900000
,XXXXXXXXXXXXXXXXXX
X      X    X    X
X       F        X
X      X    X    X
X  XXXXXXXXXX    X
X  XXXX   XXX    X
X  XXG           X
X   XXXXXXXXX    X
X     X    XX    X
X     X      XX  X
X     X        X X
X    FX          X
X XXX XX  XXX    X
X  X      X  X X X
X  X     X     X X
XX X  XXXFXX X X X
X  X  XX     X   X
X FX   XX    XX  X
X  XX    XX X    X
X   X     X      X
X   XXXX      X  X
X   XX           X
X             X  X
X              F X
XXXXXXXXXXXXXXXXXX
                  
    PPW PPPW      
 C  PPW  PPW      
    PPW PPPW WWWW 
             W    
  P    WWW    W   
      WW CW  W    
             WWWW 
   PPP W          
   P   W W        
   P P WWW      P 
   PW  W          
                P 
              W   
  P        C WW   
  W  P        W   
        CWWW  WW  
         PPW      
                  
  H        P WC   
   P      PWPW    
         PPWPWWWW 
          PWPW    
          PWP     
                  
r