6600000
,XXXXXXXXXXXXXXXXXX
X        F  XXX  X
X    XXX   X     X
X  XXX           X
X  XG  XFXXXXXX  X
X    XX XX FXFX  X
XXXX    F XXX X  X
X        X    X  X
X    XXXXX  X X  X
X  XXX      X X  X
X  X       XX X  X
X  X XX       X  X
X  X FX XXXXXXX  X
X  X  X X        X
X  X  X X F      X
X  X    X        X
X  XX   X        X
X   XX           X
X   XX  X        X
X     XX         X
X                X
X                X
X                X
X                X
XXXXXXXXXXXXXXXXXX
                  
 C             PP 
        PPP PPPPP 
                  
                  
    P     C       
     CPP          
 P                
 P PP             
 P                
 P                
 P          CH    
 P                
 P          C     
 P         PPPPPP 
 P     C PPPPPP P 
 P              P 
 P              P 
 P       C      P 
 P              P 
 PP P PPPP  P   P 
 PPP   P    PPPPP 
 PP   PPPPP P   P 
 PPPPPPPPPPPPPPPP 
                  
r