6300000
,XXXXXXXXXXXXXXXXXX
X                X
X                X
X                X
X   G            X
X                X
X                X
X                X
X                X
X                X
X                X
X                X
X                X
X                X
X                X
X                X
X                X
X                X
X                X
X                X
X                X
X  d     d    d  X
X                X
X                X
XXXXXXXXXXXXXXXXXX
                  
                  
                  
                  
           P      
     WWWW   P     
                  
                  
                  
                  
          H       
                  
         W        
     W W W        
   c     c    c   
           W      
                  
            W     
           W W    
    W     W       
                  
                  
                  
                  
                  
r