6300000
,XXXXXXXXXXXXXXXXXX
X  X           F X
X  X             X
XX               X
X                X
X                X
X             F  X
X                X
X     F          X
X                X
X                X
X                X
X  F             X
X              F X
X                X
X                X
X        F       X
X                X
X                X
X           XX X X
X   F       XX X X
X           X GXXX
X           X  XXX
X            X XXX
XXXXXXXXXXXXXXXXXX
                  
 WW WWWWWWWWWWW W 
 WW WWWWWCWWWWWWW 
  WWWWWWWWWWWWWWW 
 WWWWWWWWWWWWWWWW 
 WWWWWWWWWWWCWWWW 
 CWWCWWWWWWWWW WW 
 WWWWWWWWWWWWWWWW 
 WWWWW WWWWWWWWWW 
 WWWWWWWWWWWWWWWW 
 WWWWWWWWWWWWWWWW 
 WWWWWCWWWWWWWWWW 
 WW WWWWWWWWWWWWW 
 WWWWWWWWWWWWWW W 
 WWWWWWWWWWWCWWWW 
 WWWWWWWWWWWWWWWW 
 WWWWWWWW WWWWWWW 
 CWWWWWWWWWWWWWWW 
 WWWWWWWWWWWWWWWW 
 WWWWWWWWWWW  W W 
 WWW WWWWWWW  W W 
 WWWWWWWWWWW P    
 WWWWWWWWWWW PH   
 WWWWWWWWWWWW P   
                  
r