6600000
,XXXXXXXXXXXXXXXXXX
X                X
X                X
X  XXXXXXXXXXXX  X
X  X X XXXXX  XX X
XXX    X       X X
X    X X  XX   X X
X   X  X  XFX  X X
X XXX  X  X  X X X
X  FX X   X     FX
X XX  X   XXXXFX X
XX   XXXXX XXXX  X
XX    X          X
XFX   XXX     XXXX
X X        XX    X
X X   XX   X  XXXX
X X XXX    X  F  X
X X   XXXXXX     X
X X        XXXXX X
X XX  XX   XXXXX X
X  XXXXXXXXX     X
X          X     X
X      X         X
X      X         X
XXXXXXXXXXXXXXXXXX
                  
 PPPPPPPPPPPPPPWW 
 WWWWWWWWWWWWWWWW 
 WC             W 
 WW W       WW  W 
    PW   WWWWWW W 
   PW P  W  WWW W 
 WWP  W  W    W W 
 P   PW  W C  W W 
  C  W WCW WWWWW  
    WW WWW      W 
  WWW           W 
  WWW    WWWWWW W 
   WW    WWWWW    
 W WWWWWWWW  WH   
 W W    WW  WW    
 W W        WW WW 
 W WW        WWWW 
 W WWWWWWCW     W 
 W  WW  WWW     W 
 W          WWWWW 
 WWWWWWWWW  CW    
        WWWWWW    
                  
                  
r