6900000
,XXXXXXXXXXXXXXXXXX
X   G    G   X F X
X     G    G XX XX
X                X
X                X
X                X
X XGXXXX XXX     X
X       G FX     X
X XXXXXX XXX     X
X X    XX        X
X X    X         X
X X  XFX  F      X
X X         G    X
X X  XX  F X     X
X X       XX   XXX
X  XXX    X      X
X   X    XX      X
X   X    X       X
X   X   X   X XX X
X   X   X   X X  X
X   X   X   X X  X
X   X   X   X X  X
X           X    X
X    X           X
XXXXXXXXXXXXXXXXXX
                  
    P    P    C   
      P    P      
 PP  PPPPPPP      
  PPPPPPPPPP      
                  
        W         
        P     WPP 
 W            WPP 
 W            WPP 
 W    H    CPWWPP 
    P   PPWWWWWC  
 C  PPPPPPPPWWW   
          P WWWPP 
         P        
         P        
   W    P         
   W    P         
   W   P          
   W  WP          
   W  PP       C  
   W  WP          
                  
                  
                  
r