71800000
,XXXXXXXXXXXXXXXXXX
X                X
X                X
X                X
X                X
X                X
X                X
X       G        X
X   XXXXXXXXXX   X
X       X        X
X       X        X
X       X        X
X       XF       X
X       X        X
X       X        X
X       X        X
X       X        X
X       X        X
X                X
X                X
X                X
X                X
X                X
X                X
XXXXXXXXXXXXXXXXXX
                  
                  
   PPPPPPPP       
    P    PP       
      P     PP    
    PP       P    
              P   
         H    P   
               P  
 P   PPP          
 P  PP P        P 
 P P      PP    P 
  P    C    P     
  PP        P     
 PPP        P     
 P P        P     
 PPP      P P     
   P      P       
   P      PP      
   PPP    P       
 P    P   P       
 P  PPP PPP       
  P    PPPP       
  PP              
                  
r