6600000
,XXXXXXXXXXXXXXXXXX
X                X
X                X
X       XX       X
X      X  XXXX   X
X   XX    X FX   X
X      X    X    X
X    X  X X X    X
X XX   XX   X    X
X   XXX FXXX     X
X    X  X        X
X X  X  X        X
X X     X        X
X  XX  XX        X
X  XXXX X        X
X  XFX   X       X
X  X   X X       X
X  X X           X
X  X XXX X       X
X  X X   X       X
XX X   X X       X
X  X X   X       X
X    XXXXX       X
XFX  X   G       X
XXXXXXXXXXXXXXXXXX
                  
 PWPPPPPPPPPPPPWW 
                W 
   PPPPP  PPPWWWW 
  PPPPP         P 
                P 
                P 
             PW W 
                W 
 CWW           PP 
    P         WPP 
 C  P  W     PPPP 
       P     PPPP 
  W           WPP 
              WPP 
              PPP 
     W        PWP 
              PWP 
  P           PWP 
             WPWP 
            PPPWP 
 WW C       PWWWP 
 CW        PPWPPP 
      PPH  PWWPPP 
                  
r