71200000
,XXXXXXXXXXXXXXXXXX
XXXX       X     X
X     XXX X      X
X  GX     X   X  X
X    XXXX X   X  X
XXXX X     X  X  X
X          X X   X
X  X X    X   X  X
X X  X   X   X   X
X    X  X  X  X  X
X XXXX       X   X
X      X   X X   X
X       XXX  X   X
X  X             X
X  X      XF X   X
X  XX      X  XXXX
X  X  XX X       X
X      X X XXXXX X
X      X      X  X
X   XX X X XXXX XX
X      X X       X
X      X X XX X  X
X          X     X
X     XX   X FX  X
XXXXXXXXXXXXXXXXXX
                  
            WWWWW 
 PW        PWWPWW 
 PPC       PWW WW 
 PPWW    P WWW WW 
      WWWWW WW WW 
    HWWWWWW W WWW 
      WWPW WWW WW 
 C    PWP WWW WWW 
  W   WW WW WP WW 
      WWWWWWW WWW 
  PW PP WWP P WWW 
 P  WPPP   WP WWP 
 W  PWWWWWWWWWWWW 
     WPPPP WP WWW 
     PPPPPP PP    
                  
      W           
      W    W      
      W           
   PW             
   PW        W  W 
   PW    W      W 
                  
                  
r