6300000
,XXXXXXXXXXXXXXXXXX
X     X       X XX
X X X   X XXX    X
X  XXXXX   XXXXX X
X  X   XXX     X X
X XX X   XXXXX X X
X    X X X   X X X
XXXXX  X XXX X X X
XX     X     X X X
XX XXXXXXXXXXX X X
X                X
XX  XXXX XXXXXXXXX
XX  X FX X       X
XX  XX X X XXXXX X
XX  X  X X X FX  X
XX  X XX X X     X
XX XX XX X XXXXX X
XX X   X       X X
XX X X X  XXX  X X
XX X X         X X
XX X X    XXX  X X
X FX X  X      X X
X XX X GX XXXXXX X
X    X  X        X
XXXXXXXXXXXXXXXXXX
                  
 WWWWW WWWWWWW W  
 W W WWW W   WWWW 
 WW     WWW     W 
 WW WWW   WWWWW W 
 W  W WWW     W W 
 WWWW W W WWW W W 
     WW W   W W W 
  WWWWW WWWWW W W 
  W           W W 
 WWWWWWWPWWWWWWWW 
  WW    W         
  WW CW W WWWWWWW 
  WW  W W W     W 
  WW WW W W CW WW 
  WW W  W W WWWWW 
  W  W  W W     W 
  W WWW WWWWWWW W 
  W W W WW   WW W 
  W W WWWWWWWCW W 
  W W WWWW   WW W 
 WW W PW WWWWWW W 
 W  W PW W      W 
 WWWW PH WWWWWWWW 
                  
r