6900000
,XXXXXXXXXXXXXXXXXX
X  F   G   XX  X X
X     X        X X
X     X   XXXXFX X
X       X     XX X
XX    X    X XF  X
X     X  X   X   X
X     X      X  GX
X     X      X  GX
X     X     XX  GX
X     X        X X
X     X          X
X     X     X X XX
X     X          X
X     X      X   X
X       X      X X
X         X  X   X
X             X  X
X       X   X  X X
X      X XX XXX  X
XXXXFX         XFX
X  FX   XXX X XXXX
X   X XXX     XXXX
X G       XX    FX
XXXXXXXXXXXXXXXXXX
                  
 WWWWWWWPPP       
 WWC   PPW      H 
 CWPW             
 WWPW             
  WPW         PPW 
   PW         PPW 
   PW         PPW 
   PW         PPW 
   PW         PPW 
   PWC     CW     
   PW       W     
  CPW             
   PW             
   PW           P 
   PW             
   PW             
   PW             
    W             
    W C           
                  
 PWW              
 PCW              
 PWW              
                  
r