6300000
,XXXXXXXXXXXXXXXXXX
X           XX   X
X XXXXXX XXXX GX X
XF X  FX    X GX X
X  X  XXXXX X  X X
X  X  XX    X GX X
X  X     XXX   X X
X GX  X       X  X
X GXXXXXXXXXXXX  X
X GX             X
XX   XXXXXXXX XX X
XX XX        F X X
X       XXXXX XX X
X X XXX    X     X
X          XXXXXXX
X X XXXXX  X     X
X   XF     XX XX X
XXX XXXXXXXX   X X
X   X   X    X X X
X  GX X X XXX  X X
X  GX X X X X XX X
X  GXFX X X X FX X
X   XXX   X XXXX X
XXX     XXX      X
XXXXXXXXXXXXXXXXXX
                  
                  
 C           PW   
  P WW       PW   
    WW       PW   
    WW       PW   
       CW   P W   
 PW WW            
 PW             P 
 PP               
                  
                  
  W   WW          
   P   W  P       
  W       P       
 C        W       
          W       
                  
 PPC              
 PPW C            
 PPW       H C    
 PPW              
 PP               
                  
                  
r