6600000
,XXXXXXXXXXXXXXXXXX
X                X
X      XXX XXXX  X
X  XXXXXX        X
X  X X XX FXXXX  X
X    X X  X  FX  X
X    X   X  XXX  X
XXXX X X XX   X  X
X      X XX X X  X
X      X  X      X
X   X  X X  X X  X
X X   XX X    X  X
X   X  X X   XX  X
X X   XX   X X   X
X   X  X X   X   X
X X   XX XX X    X
X   X  X      X  X
X X   XXXXXX  XXXX
X   X X     XX   X
X   X   XXX    X X
X  X  X        X X
X  X XXXXXXX   X X
X              X X
X               GX
XXXXXXXXXXXXXXXXXX
                  
                  
          W     P 
                  
 P       PW     W 
   W              
               P  
        P      P  
           P   P  
    W W     WPW   
      W        P  
 P        PWWW P  
                  
 P            PWW 
               WW 
 P         W   WW 
               WW 
 P                
                  
   W CPC          
          P       
                  
              W   
             PPH  
                  
r