6300000
,XXXXXXXXXXXXXXXXXX
XX               X
X                X
X F XXXXXXXXXXXX X
X FX  G          X
X X  XXXXXXX    FX
XFX         XXXXXX
XXXXXXXXXXX      X
X      FF F      X
XXXXXXXXXXXXXXXX X
X     FF   F     X
X     FFFFF      X
XXXXXXXXXXXXXXXX X
XXXXXXXXXX XXXXX X
X     FFFFFFF    X
X     F F        X
XXXX XXXXXX XXX XX
X      FFF       X
X      F         X
XX  XXXXXXXXXXX XX
X     F FFFFFF   X
XXXXXXXXXXXXXXX XX
X                X
X                X
XXXXXXXXXXXXXXXXXX
                  
                  
       PWWCWWCWW  
                  
              PPW 
 C P        CW    
        PW        
                  
 C  CP C   W      
                  
   C  C W C W     
  CC C C  CWW     
                  
                  
 C CC C C P CW    
  C  C   W   CW   
                  
 C  PCC   W       
 CP     W         
  WC              
 C  CC  C C  CW   
                  
    H             
                  
                  
r