6300000
,XXXXXXXXXXXXXXXXXX
X      F         X
X                X
X     F   X      X
X         X      X
X     F   X      X
X        FX      X
X   XXXXXXX      X
X                X
X                X
X               FX
X XXXXXXXXX     FX
X X       X     FX
X X       F      X
X X XX    X     FX
X X     G X     FX
X X X   G X     FX
X X  X    X     FX
X X       F      X
X X  X    X    F X
X XXXXXXXXX     FX
X               FX
X               FX
X               FX
XXXXXXXXXXXXXXXXXX
                  
 PP      PPPPPPP  
 PP PPPPP   PPPPP 
 P CPP   W   PPPP 
 P  PPPP W    PPP 
 PCCPP   C    PP  
 P  PPPP      PP  
 PP          PP   
  P         PP    
  PP    PPPPP     
   PPPPPPP     C  
               C  
 P     PP      C  
    PPPPP W       
   C   PP      C  
      PPWW     C  
   C  PPWW     C  
 P  W  PP      C  
    PPPPP W       
 H     PP      C  
               C  
               C  
               C  
               C  
                  
r