6600000
,XXXXXXXXXXXXXXXXXX
X  G FFFFFF      X
X    FFFFFF      X
X                X
X       X        X
X                X
X   GX           X
X         FX     X
X                X
X                X
X   GX           X
X           FX   X
X                X
X                X
X      GX        X
X                X
X          FX    X
X  FX            X
XXX     FX       X
X GX             X
X  XXXXXXXXXXXXX X
X  X       F     X
X XX   FFFF      X
XF     F         X
XXXXXXXXXXXXXXXXXX
                  
 WWCCCCCC  WWWWWW 
 WWCCCCCC  WWWWWW 
 WWWW      WWWWWW 
 CWWW  P   WWWWWW 
 CWWW      WWWWWW 
 CWWP      WWWWWW 
 CWWW     P WWWWW 
 WWWW      WWWWWW 
 WWWW         C   
 WWWP      WWWWWW 
 WWWW   H  WP WWW 
 WWWW      WWWWWW 
 WWWW      WWWWWW 
 WWWW  P   WWWWWW 
 WWWW      WWWWWW 
 WWWW      P WWWW 
 WWP       WWWWWW 
   WW   P  WWWWWW 
 WW W      WWWWWW 
  W             W 
  W WPPPPPWWWWWWW 
 C  WCCCCCWPPPPPP 
  WW PCPPPWWWWWWW 
                  
r