6300000
,XXXXXXXXXXXXXXXXXX
X XX   XXX   XX XX
X    X           X
X XX X X XXXX X XX
X  X X X  X   XF X
X  X X X XXX FXXXX
X X    X  X XX   X
X   XX   X  X  X X
X XX   X  X    X X
X X  XX X  XXX X X
X  X X         X X
X X   X  X X X X X
X XX    X XX X X X
X XXXXX X    X X X
X XX     XX  X X X
X    X      XX X X
X   X XXG XX   X X
X   X    X     X X
X   XX  X  XXXXX X
X  X   X  XX   X X
X   X XX     X X X
X   X  X  XX X X X
X X      X X  XX X
XX   X X   X     X
XXXXXXXXXXXXXXXXXX
                  
                  
            W     
                  
  P      P CW     
  P          W    
   W     P H      
  WW              
      P PP        
          P       
  P               
     P  P   W     
                  
       P          
       PP  PW     
  W        P      
  WP P   P        
  WP         P    
  WP   P          
  W      P        
 CWP     PW       
  WP     P        
 P           P    
    P P           
                  
r