6600000
,XXXXXXXXXXXXXXXXXX
X    FF          X
X         X  X   X
XXXX         X X X
X         XXXX X X
X                X
X                X
XXXX          X XX
X FX          F GX
X X           X XX
X X             XX
X X          XX  X
X X             FX
X X       XXXXX XX
X X             FX
X X         FGX XX
X X          XX XX
X X          X   X
X X              X
X XG          X  X
X XXX         X  X
X          X  X  X
X          X F   X
X             X  X
XXXXXXXXXXXXXXXXXX
                  
  C               
    PPPPPP  P C   
    PPP  PPPP     
     P   P        
  C  PP  P        
    PPPPPPPPP     
    PPPPPPPPPP    
    C PP          
         PP       
     PP  PP       
     PPPP       P 
        PP        
     C   P        
     P    PP      
     PPP   P      
     PPPP         
      PPPPP       
     C   PP       
               PP 
     PPPP         
     PPPPP  PC    
      C PP  P     
   PPP P   PPP HP 
                  
r