6300000
,XXXXXXXXXXXXXXXXXX
X      XXX   G   X
X XXXX XXX XXXXXXX
X X           XXXX
X XXXX XXXXX XXXXX
X    X       XXXXX
XXXX XXXXXXXXXXXXX
X                X
X                X
X                X
X    FFFFFFFFFFF X
X   FFFFFFFFFFF  X
XFFFFFFFFFFF X   X
X     FFFFFFFFFFFX
X  FFFFFFFFFFFF  X
XFFFFFFFFFFFF X FX
X   FFFFFFFFFFFF X
X   FFFF X   F FFX
X         FFFFFFFX
X                X
X             X  X
XXXXXXXXXXXX XX  X
X                X
X   XXXXXXX      X
XXXXXXXXXXXXXXXXXX
                  
                H 
                  
   PPPPPPPWWW     
                  
                  
                  
                W 
                W 
 WWWWWWWWWWWW   W 
 CCCCCCCCCCCW PWW 
 CCCCCCCCCCCW   W 
 CCCCCCCCCCCW   W 
 CCCCCCCCCCCWW  W 
 CCCCCCCCCCCCW  W 
 CCCCCCCCCCCCW  W 
 CCCCCCCCCCCCW  W 
 CCCCP    PCCW WW 
 WWWCCCCCCCCWW WW 
 WWWWWWWWWWWWW WW 
               WW 
            W  WW 
 CPPWWWWWWWWWWWWW 
 PPP       WWWWWW 
                  
r