6300000
,XXXXXXXXXXXXXXXXXX
X               GX
X  XXXXXXXXXXXXXXX
X    X    X      X
X              X X
X      F  X      X
X      F  F    F X
X      FXXX      X
X      F         X
X      F         X
X                X
X           X    X
X      FFXX      X
X       F        X
X        F       X
X       F        X
X      FFXX      X
X                X
X                X
X      F         X
X      FFXX X    X
X      X     X   X
X  F   F    X    X
X                X
XXXXXXXXXXXXXXXXXX
                  
  P            H  
  C               
 P  P PPPP PPPPPP 
 P  PPPPPPPPPPP P 
 PPPC P P  P  PPP 
 PCPPCP PP PC P   
 PPPC       PPP P 
 PC P P P PPPP PP 
 PPCPP  PPPP PPP  
 P PPP PPPPPPPPPP 
 P PPPPPPPPP  P P 
 PPC C      PPPPP 
 PPPCPPP P   PPPP 
 PP PC PP PPPP  P 
 PC P PP P PP P P 
 P PPCC    PPPPPP 
 P   PPPPPPPPPPPP 
 P   PPPPPPPPPPPP 
 PCPPP  P PPP  PP 
 PPPC C      PP P 
 P   PP PPPPP PPP 
 PC PP  P P   PP  
 P   PPPPPPP PPPP 
                  
r