6300000
,XXXXXXXXXXXXXXXXXX
X                X
X                X
X                X
X                X
X              XXX
X               GX
X            F XXX
X            F   X
X            F   X
X            F   X
X                X
X                X
X                X
X                X
X            G  FX
X                X
X                X
X                X
X                X
X                X
X                X
X                X
X                X
XXXXXXXXXXXXXXXXXX
                  
                  
                  
   PPPPPPPPPPPWC  
             PW   
             PW   
             PW   
  CW         PW   
   W         PW   
  PW         PW   
   W         PW   
   W         PW   
   W         PW   
   W         PW   
   W         PW   
   W         PW H 
  CW              
   W              
   W              
   W              
   W              
 CCW              
   W              
                  
                  
r