6420000
,XXXXXXXXXXXXXXXXXX
X FX  FX      X  X
X X    X      X GX
X X   X   X X    X
X X XX   XX  X   X
X    X  XXX   X XX
X X XX  X XX     X
X X X  X    X    X
X X X       X    X
X X XX     X     X
X     X XXX      X
X     XXX        X
X   X XXXXXX     X
X  X             X
X   X  XXXXX     X
X  XX            X
X      XX        X
X      XFXX      X
X   X X    X     X
X X        X     X
X X X X  XXX     X
X    X XX X      X
X                X
XXFX X X X XX    X
XXXXXXXXXXXXXXXXXX
                  
               PH 
            WW PW 
 C  WW   W    PPW 
 W      W   W     
 PW          W C  
 W     W      WWW 
 W        WW  WWW 
 W        WW  WWW 
 P       PW W WWW 
   WWW     CW WWW 
   WWC   WWWW WWW 
   W W       PWWW 
             WWWW 
      W      WWWW 
      WWPW   WWWW 
     WW  W   WWWW 
  PPPPP W    WWWW 
   P P    W  WWWW 
 W        W  WWWW 
 W     WW    WWWW 
 W           PWWW 
              WWW 
              WWW 
                  
r