6240000
,XXXXXXXXXXXXXXXXXX
X                X
XF             GGX
XG               X
XGXXXXXXXXXXX    X
X      X    XX   X
X      X         X
X      X    XX   X
X      X     X   X
X      X XX  X   X
X      X       X X
X      X X X     X
X      X X   X   X
X     X   X   XX X
X       X  X X   X
X      X         X
X    X    X XX   X
X      X         X
X   X  X      X  X
X   X  XXXXX  X  X
X   X      X  X  X
X   X      X  X  X
X                X
X          X     X
XXXXXXXXXXXXXXXXXX
                  
 PPPPPPPPPPPPPPH  
  PPPPPPPPPPPPPPP 
 PPPPPPPPPPPPPP W 
 W              W 
      W           
 PPPPPW C    W  W 
 PPPPPW  W      W 
 PPPPPW  W      W 
 PPPPPW P       W 
        P       W 
                W 
                W 
                P 
     PW         W 
     PW     W  PW 
                W 
     PW         W 
                W 
            P  PW 
     PW     PW PW 
            PW PW 
          PWPPPWW 
            P  WW 
                  
r