6200000
,XXXXXXXXXXXXXXXXXX
X  X           F X
X  XXXX          X
XX   XXX         X
X   XXXX         X
X    X X         X
X    X        F  X
X    X           X
X     F          X
X XXX            X
X       F        X
X     XXX        X
X    XX X        X
X    XX X    X F X
X    XXXX        X
X    XXX         X
X    XX  F       X
X      X         X
X                X
X       X   XX X X
X   F       XX X X
X           X GXXX
X           X  XXX
X            X XXX
XXXXXXXXXXXXXXXXXX
                  
 WW WWWWWWWWWWW W 
 WW    WWCWWWWWWW 
  WWW   WPWWWWWWW 
 WWW    WWWWWWWWW 
 WWWW W PPWWCPWWW 
 CWWC WWPPWWWW WW 
 WWWW WPPPWWWWWWW 
 WWWPW PPPPWWWWWW 
 W   WPPPPPWWWWWW 
 WWWWWPP PPPWWWWW 
 WWWWW   PPPWWWWW 
 WWWW  W PPPWWWWW 
 WWWW  W WWWW W W 
 WWWW    WWWCWWWW 
 WWWW   WWWWWWWWW 
 WWWW  CW WWWWWWW 
 CWWWWW WWWWWWWWW 
 WWWWWWWWWWWWWWWW 
 WWWWWWW WWW  W W 
 WWW WWWWWWW  W W 
 WWWWWWWWWWW P    
 WWWWWWWWWWW PH   
 WWWWWWWWWWWW P   
                  
r